{
  "maze1": {
    "layout": [
      [1,1,1,1,1,1,1,1,1],
      [1,0,0,0,1,0,0,0,1],
      [1,0,1,0,1,0,1,0,1],
      [1,0,1,0,0,0,1,0,1],
      [1,0,1,1,1,0,1,0,1],
      [1,0,0,0,1,0,0,0,1],
      [1,1,1,0,1,1,1,0,1],
      [1,0,0,0,0,0,0,0,1],
      [1,1,1,1,1,1,1,1,1]
    ],
    "start": [1, 1]
  },
  
  "maze2": {
    "layout": [
      [1,1,1,1,1,1,1,1,1],
      [1,0,1,0,0,0,1,0,1],
      [1,0,1,0,1,0,1,0,1],
      [1,0,1,0,1,0,0,0,1],
      [1,0,0,0,1,1,1,0,1],
      [1,1,1,0,0,0,1,0,1],
      [1,0,0,0,1,0,1,0,1],
      [1,0,1,0,0,0,0,0,1],
      [1,1,1,1,1,1,1,1,1]
    ],
    "start": [1, 7]
  },
  
  "maze3": {
    "layout": [
      [1,1,1,1,1,1,1,1,1],
      [1,0,0,1,0,0,0,0,1],
      [1,0,1,1,0,1,1,0,1],
      [1,0,1,0,0,0,1,0,1],
      [1,0,0,0,1,1,1,0,1],
      [1,1,1,0,0,0,0,0,1],
      [1,0,0,0,1,0,1,0,1],
      [1,0,1,0,0,0,1,0,1],
      [1,1,1,1,1,1,1,1,1]
    ],
    "start": [1, 1]
  },

  "maze4": {
    "layout": [
      [1,1,1,1,1,1,1,1,1],
      [1,0,1,0,0,1,0,0,1],
      [1,0,1,0,1,1,1,0,1],
      [1,0,0,0,0,0,1,0,1],
      [1,1,1,1,0,1,1,0,1],
      [1,0,0,1,0,0,0,0,1],
      [1,0,1,1,0,1,1,1,1],
      [1,0,0,0,0,0,0,0,1],
      [1,1,1,1,1,1,1,1,1]
    ],
    "start": [7, 7]
  },

  "small_maze1": {
    "layout": [
      [1,1,1,1,1],
      [1,0,0,0,1],
      [1,0,1,0,1],
      [1,0,0,0,1],
      [1,1,1,1,1]
    ],
    "start": [1, 1]
  },

  "small_maze2": {
    "layout": [
      [1,1,1,1,1],
      [1,0,1,0,1],
      [1,0,0,0,1],
      [1,1,0,1,1],
      [1,1,1,1,1]
    ],
    "start": [1, 1]
  },

  "small_maze3": {
    "layout": [
      [1,1,1,1,1],
      [1,0,0,1,1],
      [1,0,1,0,1],
      [1,0,0,0,1],
      [1,1,1,1,1]
    ],
    "start": [1, 1]
  },

  "small_maze4": {
    "layout": [
      [1,1,1,1,1],
      [1,0,1,0,1],
      [1,0,1,0,1],
      [1,0,0,0,1],
      [1,1,1,1,1]
    ],
    "start": [3, 3]
  }
}